###############
#             #
#             #
#  ##    ##   #
#             #
###############